# Template.c
MsgWarningMultipleRoomDefinitions=WARNING: Multiple room control definitions found (%i), creating first found %i.
MsgWarningNoRoomDefinition=WARNING: No room control definition found.
MsgWarningNoEntrances=WARNING: Room has no entrances, create one.
MsgWarningTooManyEntrances=WARNING: Room has more than one entrances, remove the superfluous ones.
MsgWarningNoExits=WARNING: Room has no exits, create one.
MsgWarningTooManyExits=WARNING: Room has more than one exits, remove the superfluous ones.

MsgWarningTooManyTablets=WARNING: Found %d ancient tablets, only one allowed, remove the superfluous ones.
MsgWarningTabletFoundNoControl=WARNING: %d ancient tablet(s) found, but not specified in room control object.
MsgWarningNoTabletFound=WARNING: No Ancient Tablet found, but it was specified in room control object.

MsgWarningTooManyJokers=WARNING: Found %d Jokers, only one allowed, remove the superfluous ones.
MsgWarningJokerFoundNoControl=WARNING: %d Joker(s) found, but not specified in room control object.
MsgWarningNoJokerFound=WARNING: No Joker found, but it was specified in room control object.

MsgRoomHasName=Your room has name: %s
MsgRoomHasDescription=Your room has description: %s
MsgRoomHasAuthor=Your room has author: %s


# Queue.c
MsgJoinsWatchList=%s schaut ab jetzt zu.
MsgLeavesWatchList=%s hat sich in der Schlange eingereiht.


# EditorBase.c
MakeRoomPlayerOwner=Room owner
MakeRoomPlayerOwnerHelp=The player who attempts this room will be made the owner of this object.


# GameSpeed.c
MsgWarningNoGameSpeed=WARNING: You are not allowed to change the game speed.


# Voting.c
MsgVoteAbortAttempt=%s stimmt f√ºr einen Neustart.
MsgVoteNotAbortAttempt=%s takes back his vote to abort the attempt.
MsgVotingCompleted=%s darf per Mehrheitsbeschluss nicht weiter versuchen!


# Rating.c
MsgRatingGiven=%s rated room %s with %d/5 stars.
MsgRatingUpdated=%s changed the rating for room %s to %d/5 stars.
MsgDifficultyRatingGiven=%s rated the difficulty of room %s as %s.
MsgDifficultyRatingUpdated=%s changed the difficulty rating for room %s to %s.
MsgDifficultyTrivial=trivial
MsgDifficultyEasy=easy
MsgDifficultyMedium=medium
MsgDifficultyHard=hard
MsgDifficultyExtreme=extreme